00000000000000000000000000000000000000000000000000000000000000000000000000000000
00000000000000000000000000000000000000000000000000000000000000000000000000000000
00000000000000000000000000000000000000000000000000000000000000000000000000000000
00010001000100000000000000000000000000000017000000000000000000000000004700000000
00020002000200010001000000000000000000000017000000000000000000010001000100010001
00020002000200020002000100010000005400000017000000530000000100020002000200020002
00020002000200020002000200020001000100010001000100010001000200020002000200020002
00020002000200020002000200020002000200020002000200020002000200020002000200020002
texture[0808]=null